11111111
10CCCC01
1P0110E1
11111111