111111111111111111111111
1000000000000000000000E1
100101111111111111001001
100101000010000001C01111
1001C1010010100001100001
100111010010100000111111
100010010010100000000001
10001C010000100000000001
100011111111111000000001
100000000000000000C00001
1P0000000000000000000001
111111111111111111111111
111111111111111111111111
111111111111111111111111