11111111111111111
1C000000001C001E1
11111000001110101
10000000011000101
10000010000000101
1P00011C000100001
11111111111111111
11111111111111111