11111111111111111111
10010000000C00000001
1000011111000000X001
1P001100000000000001
10111001110100000001
100000C0000000000001
11111111111111111111