
1111111111111
1P010000100C1
1F00011111001
1F0011E000001
1111111111111
